<-	â†
->	â†’
<->	â†”ï¸
\up	â†‘
\down	â†“
cmd	âŒ˜
\shift	â‡§
\opt	âŒ¥
leq	â‰¤
geq	â‰¥
leaq	â‰²
geaq	â‰³
neq	â‰ 
<<	â‰ª
>>	â‰«
\pm	Â±
1/2	Â½
squared	Â²
cubed	Â³
infty	âˆ
elementof	âˆˆ
notelementof	âˆ‰
lambda	Î»
pi	Ï€
theta	Î¸
:+1:	ğŸ‘
